{
    "A": "C",
    "B": "I",
    "C": "O",
    "D": "V",
    "E": "Y",
    "F": "B",
    "G": "L",
    "H": "K",
    "I": "F",
    "J": "T",
    "K": "",
    "L": "M",
    "M": "A",
    "N": "D",
    "O": "",
    "P": "H",
    "Q": "P",
    "R": "S",
    "S": "J",
    "T": "N",
    "U": "U",
    "V": "R",
    "W": "G",
    "X": "E",
    "Y": "W",
    "Z": ""
}
